%%%%%%%%%%%
%S        %
%         %
%    A    %
%        A%
%      A S%
%%%%%%%%%%%
