###########
#      A  #
# S     A #
#         #
#   A     #
#       A #
###########
