###########
#AA    A  #
# S A   A #
#         #
#A  A     #
#  A    A #
###########
