###########
# SSSS    #
# SS      #
#      S  #
#         #
###########
